44,44,44,44,44,44,44,44,44,44,44,41,41,41,41,41,41,41,41,41,41,41,41,41,41,
42,42,42,42,42,42,42,42,42,42,42,42,42,42,42,42,42,42,42,42,42,42,42,42,42,
43,43,43,43,43,43,43,43,43,43,43,43,43,43,43,43,43,43,43,43,43,43,43,43,43,
8,9,10,11,12,107,108,43,43,43,43,43,43,43,43,43,17,18,19,20,11,12,13,14,15,
90,91,92,93,94,113,109,110,111,106,106,106,106,106,106,82,82,84,83,82,96,92,94,89,82,
44,44,44,44,44,44,44,112,106,106,106,106,106,106,106,44,44,44,44,44,44,44,44,44,44,
44,44,44,44,44,44,44,44,44,44,44,44,44,44,44,44,44,44,44,44,44,44,44,44,44,
